{
  "version": "1.0",
  "gridWidth": "20",
  "gridHeight": "20",
  "floorMap": [
    2,2,2,2,2,2,2,2,2,2,2,2,2,2,2,2,2,2,2,2,
    2,0,0,0,0,0,0,0,2,0,0,0,0,0,0,0,2,0,0,2,
    2,0,0,2,0,2,0,0,2,0,0,2,0,2,0,0,2,0,0,2,
    2,2,2,2,0,2,2,2,2,2,2,2,0,2,2,2,2,0,0,0,
    2,0,0,0,0,0,0,0,2,0,0,0,0,0,0,0,2,0,0,0,
    2,0,0,2,0,2,0,0,2,0,0,2,0,2,0,0,2,0,0,0,
    2,2,2,2,0,2,2,2,2,2,2,2,0,2,2,2,2,0,0,0,
    2,0,0,0,0,0,0,0,2,0,0,0,0,0,0,0,2,0,0,0,
    2,0,0,2,0,2,0,0,2,0,0,2,0,2,0,0,2,0,0,0,
    2,2,2,2,0,2,2,2,2,2,2,2,0,2,2,2,2,0,0,0,
    2,0,0,0,0,0,0,0,0,0,0,0,0,0,0,0,0,0,0,0,
    2,0,0,0,0,0,0,0,2,0,0,0,0,0,0,0,0,0,0,0,
    2,0,0,0,0,0,0,0,0,0,0,0,0,0,0,0,0,0,0,0,
    2,2,2,2,2,2,2,2,2,0,0,0,0,0,0,0,0,0,0,0,
    0,0,0,0,0,0,0,0,0,0,0,0,0,0,0,0,0,0,0,0,
    0,0,0,0,0,0,0,0,0,0,0,0,0,0,0,0,0,0,0,0,
    2,2,2,2,2,2,2,2,2,2,2,2,2,2,2,0,0,0,0,0,
    0,0,0,0,0,0,0,0,0,0,0,0,0,0,2,0,0,0,0,0,
    0,0,0,0,0,0,0,0,0,0,0,0,0,0,2,0,0,0,0,0,
    0,0,0,0,0,0,0,0,0,0,0,0,0,0,2,0,0,0,0,0
  ],
  "entities": [
    {"type": "entity-player", "x": 0, "y": 0, "direction": "SOUTH", "assetId": "player"},
    {"type": "spawn-player", "x": 1, "y": 1, "direction": "SOUTH"}
  ],
  "defs": {
    "0": {
      "model": "assets/models/tile.glb",
      "sprite": "assets/sprites/tile1.webp"
    },
    "2": {
      "model": "assets/models/wall.glb",
      "sprite": "assets/sprites/wall1.webp",
      "impassable": true
    }, 
    "player": {
      "sprite": "assets/sprites/player.webp"
    }
  }
}